▢▢▢▢▢▢▢▢▢▢▢▢▢▢▢▢▢▢▢▢▢▢▢▢▢▢▢▢▢▢
↘↓↓↓↓↓↓↓↓↓↓↓↓↓↓↓↓↓↓↓↓↓↓↙▢▢▢▢▢▢
→                      ←▢▢▢▢▢▢
→                      ←▢▢▢▢▢▢
→                      ←▢▢▢▢▢▢
→                      ←▢▢▢▢▢▢
→                      ←▢▢▢▢▢▢
→_     0               ←▢▢▢▢▢▢
↗↑↑↥↥↥↑↑↥↥↥↑↙          ←▢▢▢▢▢▢
↘↓↓↧↧↧↓↓↧↧↧↓↖          ←▢▢▢▢▢▢
→                      ←▢▢▢▢▢▢
→                      ←▢↘↓↓↓↙
→     @                ↗↓↖   ←
↗↑↑↑↑↑↑↑↑↑↑↑↑↑          |    ←
▢▢▢▢▢▢▢▢▢▢▢▢▢→            ▮  ←
▢▢▢▢▢▢▢▢▢▢▢▢▢↗↑↑↑↑↑↑↑↑↑↑↑↑↑↑↑↖
▢▢▢▢▢▢▢▢▢▢▢▢▢▢▢▢▢▢▢▢▢▢▢▢▢▢▢▢▢▢