▢▢▢▢▢▢▢▢▢▢▢▢▢▢▢▢▢▢▢▢▢▢▢▢▢▢▢▢▢▢
↘↓↓↓↓↓↓↓↓↓↓↓↓↓↓↓↓↓↓↓↓↓↓↙▢▢▢▢▢▢
→                      ←▢▢▢▢▢▢
→                      ←▢▢▢▢▢▢
→                      ←▢▢▢▢▢▢
→                      ←▢▢▢▢▢▢
→                      ←▢▢▢▢▢▢
→_     0               ←▢▢▢▢▢▢
↗↑↑↥↥↥↑↑↥↥↥↑↑          ←▢▢▢▢▢▢
↘↓↓↧↧↧↓↓↧↧↧↓⤣          ←▢▢▢▢▢▢
→                      ←▢▢▢▢▢▢
→                      ←▢↘↓↓↓↙
→     @                ⤤↓⤣   ←
↗↑↑↑↑↑↑↑↑↑↑↑↑↑          |    ←
▢▢▢▢▢▢▢▢▢▢▢▢▢→            ▮  ←
▢▢▢▢▢▢▢▢▢▢▢▢▢↗↑↑↑↑↑↑↑↑↑↑↑↑↑↑↑↖
▢▢▢▢▢▢▢▢▢▢▢▢▢▢▢▢▢▢▢▢▢▢▢▢▢▢▢▢▢▢